|-----+----------|
| code|RoomNumber|
|-----+----------|
|12112|       123|
|12113|       321|
|12114|       Mak|