|-----+----------|
| code|RoomNumber|
|-----+----------|
|   12|       123|
|   13|       321|
|   14|       Mak|